WWWWWWWW
WWWPXXWW
WTPBXXWW
WWWXBTWW
WTWWBXWW
WXWXTXWW
WBXXBBTW
WXXXTXXW
WWWWWWWW