WWWWWWWW
WXXXXWWW
WXXXTTXW
WXBBBPXW
WXXWXTXW
WWWWWWWW