WWWWWWW
WPXXXWW
WXBBXXW
WXWTXTW
WXXXXXW
WWWWWWW