WWWWWWW
WWWXXWW
WPXTBWW
WXXXBXW
WXWTXXW
WXXXXXW
WWWWWWW