WWWWWWWWWWWW
WXXXWWWWXXXW
WXXXWWWWXXXW
WXXXXXXXXXXW
WWWXWWWWXWWW
WWWXWWWWXWWW
WWWXWWWWXWWW
WWWXWWWWXWWW
WXXBXXWXXPTW
WXXXWXXXWWWW
WXXXWWWWWWWW
WWWWWWWWWWWW