XXXXWWWWWWWWWWWWWWWWWW
XXXXWXXXWWWWWWWWWWWWWW
XXXXWBXXWWWWWWWWWWWWWW
XXWWWXXBWWWWWWWWWWWWWW
XXWXXBXXBXWWWWWWWWWWWW
WWWXWXWWWXWXXXXXWWWWWW
WXXXWXWWWXWWWWWWWXXTTW
WXBXXBXXXXXXXXXXXXXTTW
WWWWWXWWWWXWPWWWWXXTTW
XXXXWXXXXXXWWWXXWWWWWW
XXXXWWWWWWWWXXXXXXXXXX
