WWWWWWW
WXXWXXW
WTXBBXW
WTWBXXW
WTWXBXW
WTWXXPW
WWWWWWW