WWWWWWWW
WWWXXXWW
WTPBXXWW
WWWXBTWW
WTWWBXWW
WXWXTXWW
WBXXBBTW
WXXXTXXW
WWWWWWWW