WWWWW
WPWWW
WBWWW
WXWWW
WXXTW
WXWWW
WWWWW