WWWWW
WPWWW
WBWWW
WXWWW
WXWWW
WTWWW
WWWWW