WWWWWWWWWWWWXX
WTTXXWXXXXXWWW
WTTXXWXBXXBXXW
WTTXXWBWWWWXXW
WTTXXXXPXWWXXW
WTTXXWXWXXBXWW
WWWWWWXWWBXBXW
XXWXBXXBXBXBXW
XXWXXXXWXXXXXW
XXWWWWWWWWWWWW