WWWWWWWWWW
WXXXXXXXXW
WXXXBWBWPW
WXTTXXXXXW
WXWWWBBBXW
WXWTTXTWXW
WXXXXXXXXW
WWWWWWWWWW