WWWWWWWWWW
WXXXXXXXXW
WXXBXWXWPW
WXTXXXXXXW
WXWWWXBBXW
WXWTTXXWXW
WXXXXXXXXW
WWWWWWWWWW