WWWWWWWWWWWWXX
WTXXXWXXXXXWWW
WTXXXWXXXXBXXW
WTTXXWXWWWWXXW
WTXXXXXPXWWXXW
WTXXXWXWXXBXWW
WWWWWWXWWBXBXW
XXWXBXXXXBXXXW
XXWXXXXWXXXXXW
XXWWWWWWWWWWWW