WWWWWWWW
WXXXWXXW
WXWXWBTW
WXXXXBTW
WXWXWBTW
WXXXWXXW
WWWWWPXW
WWWWWWWW