WWWWWW
WXXPXW
WBWWWW
WXWWWW
WXWWWW
WTWWWW
WWWWWW