XXXXXXXXXXXXXXXXXXXX
XXXXXXXXXXXXXXXXXXXX
XXPXXXXXWWWWWXXXXXXX
XXXXWWWWWXXXXXXXXXXX
XXXXWXXXWXXXXWXXXXXX
XXXXXXXXWXXXXWXXXXXX
XXWXXXXXWXXXXWWWWWXW
WWWWWWXXWXXXXWXXXXXX
XXWXXXXXWXXXXWXXWWWW
XXWXXXXXWXXWWWXXXWXX
XXWXWWWWWXXXXWXXXWXX
XXWXXXWXXXWXXXXXXWXX
XXWXXXWXXXWXXXXXXWXX
XXWXXXWXWWWXXXXXXWXX
XXWXXXWXXXWXXXXXBWXX
XXWXXXWXXXWXXXXXXWXX
XXXXXXWXXXWWWWWXXWXX
XXXXXXWXXXWXXXXXXXXX
XXXTXXWXXXWXXXXXXXXX